****************
*             E*
*              *
*****          *
*              *
*    *         *
*S   *         *
****************